['SFFFFFHHHHHHHHHHHHFFFFFG',
'FFFFFFHHHHHHHHHHHHFFFFFF',
'FFFFFFHHHHHHHHHHHHFFFFFF',
'FFFFFFHHHHHHHHHHHHFFFFFF',
'FFFFFFHHHHHHHHHHHHFFFFFF',
'FFFFFFHHHHHHHHHHHHFFFFFF',
'FFFFFFHHHHHHHHHHHHFFFFFF',
'FFFFFFHHHHHHHHHHHHFFFFFF',
'FFFFFFHHHHHHHHHHHHFFFFFF',
'FFFFFFHHHHHHHHHHHHFFFFFF',
'FFFFFFHHHHHHHHHHHHFFFFFF',
'FFFFFFHHHHHHHHHHHHFFFFFF',
'FFFFFFHHHHHHHHHHHHFFFFFF',
'FFFFFFHHHHHHHHHHHHFFFFFF',
'FFFFFFHHHHHHHHHHHHFFFFFF',
'FFFFFFHHHHHHHHHHHHFFFFFF',
'FFFFFFHHHHHHHHHHHHFFFFFF',
'FFFFFFHHHHHHHHHHHHFFFFFF',
'FFFFFFFFFFFFFFFFFFFFFFFF',
'FFFFFFFFFFFFFFFFFFFFFFFF',
'FFFFFFFFFFFFFFFFFFFFFFFF',
'FFFFFFFFFFFFFFFFFFFFFFFF',
'FFFFFFFFFFFFFFFFFFFFFFFF',
'FFFFFFFFFFFFFFFFFFFFFFFF']
