['SFFFFFFFHHHHHHHHHHHHHHHHFFFFFFFG',
'FFFFFFFFHHHHHHHHHHHHHHHHFFFFFFFF',
'FFFFFFFFHHHHHHHHHHHHHHHHFFFFFFFF',
'FFFFFFFFHHHHHHHHHHHHHHHHFFFFFFFF',
'FFFFFFFFHHHHHHHHHHHHHHHHFFFFFFFF',
'FFFFFFFFHHHHHHHHHHHHHHHHFFFFFFFF',
'FFFFFFFFHHHHHHHHHHHHHHHHFFFFFFFF',
'FFFFFFFFHHHHHHHHHHHHHHHHFFFFFFFF',
'FFFFFFFFHHHHHHHHHHHHHHHHFFFFFFFF',
'FFFFFFFFHHHHHHHHHHHHHHHHFFFFFFFF',
'FFFFFFFFHHHHHHHHHHHHHHHHFFFFFFFF',
'FFFFFFFFHHHHHHHHHHHHHHHHFFFFFFFF',
'FFFFFFFFHHHHHHHHHHHHHHHHFFFFFFFF',
'FFFFFFFFHHHHHHHHHHHHHHHHFFFFFFFF',
'FFFFFFFFHHHHHHHHHHHHHHHHFFFFFFFF',
'FFFFFFFFHHHHHHHHHHHHHHHHFFFFFFFF',
'FFFFFFFFHHHHHHHHHHHHHHHHFFFFFFFF',
'FFFFFFFFHHHHHHHHHHHHHHHHFFFFFFFF',
'FFFFFFFFHHHHHHHHHHHHHHHHFFFFFFFF',
'FFFFFFFFHHHHHHHHHHHHHHHHFFFFFFFF',
'FFFFFFFFHHHHHHHHHHHHHHHHFFFFFFFF',
'FFFFFFFFHHHHHHHHHHHHHHHHFFFFFFFF',
'FFFFFFFFHHHHHHHHHHHHHHHHFFFFFFFF',
'FFFFFFFFHHHHHHHHHHHHHHHHFFFFFFFF',
'FFFFFFFFFFFFFFFFFFFFFFFFFFFFFFFF',
'FFFFFFFFFFFFFFFFFFFFFFFFFFFFFFFF',
'FFFFFFFFFFFFFFFFFFFFFFFFFFFFFFFF',
'FFFFFFFFFFFFFFFFFFFFFFFFFFFFFFFF',
'FFFFFFFFFFFFFFFFFFFFFFFFFFFFFFFF',
'FFFFFFFFFFFFFFFFFFFFFFFFFFFFFFFF',
'FFFFFFFFFFFFFFFFFFFFFFFFFFFFFFFF',
'FFFFFFFFFFFFFFFFFFFFFFFFFFFFFFFF']
