['SFFFFFFFFFFFHHHHHHHHHHHHHHHHHHHHHHHHFFFFFFFFFFFG',
'FFFFFFFFFFFFHHHHHHHHHHHHHHHHHHHHHHHHFFFFFFFFFFFF',
'FFFFFFFFFFFFHHHHHHHHHHHHHHHHHHHHHHHHFFFFFFFFFFFF',
'FFFFFFFFFFFFHHHHHHHHHHHHHHHHHHHHHHHHFFFFFFFFFFFF',
'FFFFFFFFFFFFHHHHHHHHHHHHHHHHHHHHHHHHFFFFFFFFFFFF',
'FFFFFFFFFFFFHHHHHHHHHHHHHHHHHHHHHHHHFFFFFFFFFFFF',
'FFFFFFFFFFFFHHHHHHHHHHHHHHHHHHHHHHHHFFFFFFFFFFFF',
'FFFFFFFFFFFFHHHHHHHHHHHHHHHHHHHHHHHHFFFFFFFFFFFF',
'FFFFFFFFFFFFHHHHHHHHHHHHHHHHHHHHHHHHFFFFFFFFFFFF',
'FFFFFFFFFFFFHHHHHHHHHHHHHHHHHHHHHHHHFFFFFFFFFFFF',
'FFFFFFFFFFFFHHHHHHHHHHHHHHHHHHHHHHHHFFFFFFFFFFFF',
'FFFFFFFFFFFFHHHHHHHHHHHHHHHHHHHHHHHHFFFFFFFFFFFF',
'FFFFFFFFFFFFHHHHHHHHHHHHHHHHHHHHHHHHFFFFFFFFFFFF',
'FFFFFFFFFFFFHHHHHHHHHHHHHHHHHHHHHHHHFFFFFFFFFFFF',
'FFFFFFFFFFFFHHHHHHHHHHHHHHHHHHHHHHHHFFFFFFFFFFFF',
'FFFFFFFFFFFFHHHHHHHHHHHHHHHHHHHHHHHHFFFFFFFFFFFF',
'FFFFFFFFFFFFHHHHHHHHHHHHHHHHHHHHHHHHFFFFFFFFFFFF',
'FFFFFFFFFFFFHHHHHHHHHHHHHHHHHHHHHHHHFFFFFFFFFFFF',
'FFFFFFFFFFFFHHHHHHHHHHHHHHHHHHHHHHHHFFFFFFFFFFFF',
'FFFFFFFFFFFFHHHHHHHHHHHHHHHHHHHHHHHHFFFFFFFFFFFF',
'FFFFFFFFFFFFHHHHHHHHHHHHHHHHHHHHHHHHFFFFFFFFFFFF',
'FFFFFFFFFFFFHHHHHHHHHHHHHHHHHHHHHHHHFFFFFFFFFFFF',
'FFFFFFFFFFFFHHHHHHHHHHHHHHHHHHHHHHHHFFFFFFFFFFFF',
'FFFFFFFFFFFFHHHHHHHHHHHHHHHHHHHHHHHHFFFFFFFFFFFF',
'FFFFFFFFFFFFHHHHHHHHHHHHHHHHHHHHHHHHFFFFFFFFFFFF',
'FFFFFFFFFFFFHHHHHHHHHHHHHHHHHHHHHHHHFFFFFFFFFFFF',
'FFFFFFFFFFFFHHHHHHHHHHHHHHHHHHHHHHHHFFFFFFFFFFFF',
'FFFFFFFFFFFFHHHHHHHHHHHHHHHHHHHHHHHHFFFFFFFFFFFF',
'FFFFFFFFFFFFHHHHHHHHHHHHHHHHHHHHHHHHFFFFFFFFFFFF',
'FFFFFFFFFFFFHHHHHHHHHHHHHHHHHHHHHHHHFFFFFFFFFFFF',
'FFFFFFFFFFFFHHHHHHHHHHHHHHHHHHHHHHHHFFFFFFFFFFFF',
'FFFFFFFFFFFFHHHHHHHHHHHHHHHHHHHHHHHHFFFFFFFFFFFF',
'FFFFFFFFFFFFHHHHHHHHHHHHHHHHHHHHHHHHFFFFFFFFFFFF',
'FFFFFFFFFFFFHHHHHHHHHHHHHHHHHHHHHHHHFFFFFFFFFFFF',
'FFFFFFFFFFFFHHHHHHHHHHHHHHHHHHHHHHHHFFFFFFFFFFFF',
'FFFFFFFFFFFFHHHHHHHHHHHHHHHHHHHHHHHHFFFFFFFFFFFF',
'FFFFFFFFFFFFFFFFFFFFFFFFFFFFFFFFFFFFFFFFFFFFFFFF',
'FFFFFFFFFFFFFFFFFFFFFFFFFFFFFFFFFFFFFFFFFFFFFFFF',
'FFFFFFFFFFFFFFFFFFFFFFFFFFFFFFFFFFFFFFFFFFFFFFFF',
'FFFFFFFFFFFFFFFFFFFFFFFFFFFFFFFFFFFFFFFFFFFFFFFF',
'FFFFFFFFFFFFFFFFFFFFFFFFFFFFFFFFFFFFFFFFFFFFFFFF',
'FFFFFFFFFFFFFFFFFFFFFFFFFFFFFFFFFFFFFFFFFFFFFFFF',
'FFFFFFFFFFFFFFFFFFFFFFFFFFFFFFFFFFFFFFFFFFFFFFFF',
'FFFFFFFFFFFFFFFFFFFFFFFFFFFFFFFFFFFFFFFFFFFFFFFF',
'FFFFFFFFFFFFFFFFFFFFFFFFFFFFFFFFFFFFFFFFFFFFFFFF',
'FFFFFFFFFFFFFFFFFFFFFFFFFFFFFFFFFFFFFFFFFFFFFFFF',
'FFFFFFFFFFFFFFFFFFFFFFFFFFFFFFFFFFFFFFFFFFFFFFFF',
'FFFFFFFFFFFFFFFFFFFFFFFFFFFFFFFFFFFFFFFFFFFFFFFF']
